1111111111111
1000000000001
10000P0000001
100C0000E0001
1111111111111
